1111111111
1E100000P1
10000000C1
11000000C1
10000000C1
10000000C1
10000000C1
10000000C1
10000000C1
10000000C1
1111111111
