1111111111111
1000P00000E01
1111100000001
1000001111001
1000000000001
1111111111111