111111111111111
1E10001000001P1
1010000C0000101
100000110000001
111111111111111