111111111111111
1E1C001C001C001
101010101010101
101010101010001
101010101010101
1P001C001C001C1
111111111111111