111111111111111
1E1CCC1CCC1CCC1
1C1C1C1C1C1C1C1
1C1C1C1C1C1C1C1
1C1C1C1C1C1C1C1
1C1C1C1C1C1C1C1
1C1C1C1C1C1C1C1
1C1C1C1C1C1C1C1
1C1C1C1C1C1C1C1
1C1C1C1C1C1C1C1
1C1C1C1C1C1C1C1
1C1C1C1C1C1C1C1
1C1C1C1C1C1C1C1
1CCC1CCC1CCC1P1
111111111111111