111111111111
1P00000000C1
100001110001
100C10E01001
100010001001
100001010001
100000000001
1C0011000001
111111111111