11111111111111111111111
1E000000000000000000001
100000000C0000000000001
1000M011110000000000001
10000000000000000000001
10C000000000000M00000P1
11111111111111111111111