11111111111111111
1C000000E000000C1
100000001000000M1
10000111111100001
10000100P00100001
10M00100000100M01
10000111011100001
10000000000000001
10000000C00000001
11111111111111111