111111111111111111
1P10000000000000E1
10100000000000M001
10100000000000M001
101CM0000000000001
101110000000111001
101M000000001C0001
100000000000100001
111111111111111111