1111111111111
10000010000E1
1P00110110001
1001000010001
10C0100110001
1000000000001
1111111111111