11111111
1111E1C1
11110101
11000101
11100101
11000C01
110001C1
11000101
11C00101
1P0100C1
11111111


