11111111
1000C001
1P000E01
10000001
11111111