111111111
1P00C10E1
100000011
100000001
111111111