111111111111
1000000100E1
100000000001
1000000C0001
1P0000000001
111111111111